###########################################################
#                              #     #          ###########
# ###     #             ##     #     ###        ###########
#        #   ###    ### #     #     ::::    # #############
# ###                    #     #    :  :   :::::s##########
#        #############   #     #:::::  :   : ##############
#                        # ### #:      :::::    ###########
#                        #      :::             ###########
##################################x########################
